Û _ _ _ Î
Á _ _ _ Z
Â _ _ _ G
Ò _ _ _ J
Ð _ _ _ D

D _ Ð Å Ø
Å D _ Z _
Z Å Á _ Ë
Î _ Û _ R
G _ Â Æ Ý
Æ G _ J _
J Æ Ò _ Ù

Ø _ D _ Ñ
Ë _ Z _ W
Ý _ G _ S
Ù _ J _ Ó

W _ Ë È Ê
È W _ R _
R È Î Ì Ô
Ì R _ S _
S Ì Ý _ ß
Ó _ Ù _ I

Ñ _ Ø _ F
Ê _ W _ Q
Ô _ R _ V
ß _ S _ U

F _ Ñ Ä _
Q Ä Ê Õ À
V Õ Ô Ö _
U Ö ß Ç Ã
I Ç Ó _ _

Ä F _ Q _
Õ Q _ V _
Ö V _ U _
Ç U _ I _

À _ Q _ _
Ã _ U _ _